year,country,(ISO),Refugees,Asylum-seekers,total
2011,Algeria,DZA,0,5,5
2011,Egypt,EGY,9,85,94
2011,Armenia,ARM,6,0,6
2011,Australia,AUS,84,66,150
2011,Austria,AUT,903,456,1359
2011,Bahrain,BHR,0,5,5
2011,Belgium,BEL,312,666,978
2011,Brazil,BRA,6,13,19
2011,Bulgaria,BGR,98,70,168
2011,Canada,CAN,547,251,798
2011,Chad,TCD,5,0,5
2011,Cyprus,CYP,137,345,482
2011,Czechia,CZE,23,0,23
2011,Denmark,DNK,1197,93,1290
2011,Ecuador,ECU,11,0,11
2011,Finland,FIN,86,75,161
2011,France,FRA,351,0,351
2011,United Kingdom of Great Britain and Northern Ireland,GBR,693,339,1032
2011,Germany,DEU,10155,4713,14868
2011,Greece,GRC,10,0,10
2011,Croatia,HRV,0,5,5
2011,Hungary,HUN,42,0,42
2011,Indonesia,IDN,0,7,7
2011,Ireland,IRL,27,17,44
2011,Iraq,IRQ,323,1391,1714
2011,Italy,ITA,262,0,262
2011,Jordan,JOR,193,2618,2811
2011,Kyrgyzstan,KGZ,9,10,19
2011,Kuwait,KWT,10,10,20
2011,Lebanon,LBN,124,368,492
2011,Lithuania,LTU,5,0,5
2011,Latvia,LVA,5,11,16
2011,"China, Macao SAR",MAC,0,5,5
2011,Rep. of Moldova,MDA,11,10,21
2011,Malaysia,MYS,5,8,13
2011,Morocco,MAR,0,5,5
2011,Malta,MLT,80,72,152
2011,Netherlands,NLD,1064,231,1295
2011,Norway,NOR,171,336,507
2011,New Zealand,NZL,35,0,35
2011,Oman,OMN,7,5,12
2011,Pakistan,PAK,8,0,8
2011,Poland,POL,10,10,20
2011,Qatar,QAT,8,0,8
2011,Romania,ROU,20,27,47
2011,Russian Federation,RUS,5,13,18
2011,Saudi Arabia,SAU,14,12,26
2011,Spain,ESP,32,0,32
2011,Slovakia,SVK,23,0,23
2011,Slovenia,SVN,0,6,6
2011,Sweden,SWE,1206,485,1691
2011,Switzerland,CHE,1074,1066,2140
2011,Thailand,THA,0,8,8
2011,Tunisia,TUN,11,0,11
2011,Turkey,TUR,19,205,224
2011,United Arab Emirates,ARE,37,6,43
2011,Ukraine,UKR,43,176,219
2011,United States of America,USA,373,112,485
2011,Yemen,YEM,42,24,66
2012,Albania,ALB,0,5,5
2012,Algeria,DZA,0,236,236
2012,Egypt,EGY,12836,0,12836
2012,Argentina,ARG,40,9,49
2012,Armenia,ARM,136,340,476
2012,Australia,AUS,204,75,279
2012,Austria,AUT,1675,694,2369
2012,Azerbaijan,AZE,5,6,11
2012,Bahrain,BHR,0,5,5
2012,Belgium,BEL,355,938,1293
2012,Belarus,BLR,0,11,11
2012,Brazil,BRA,42,67,109
2012,Bosnia and Herzegovina,BIH,5,26,31
2012,Bulgaria,BGR,97,0,97
2012,Canada,CAN,533,404,937
2012,Chad,TCD,5,0,5
2012,Chile,CHL,0,5,5
2012,Cameroon,CMR,0,5,5
2012,Cuba,CUB,11,5,16
2012,Cyprus,CYP,139,946,1085
2012,Czechia,CZE,54,70,124
2012,Denmark,DNK,1903,115,2018
2012,Dominican Rep.,DOM,7,0,7
2012,Ecuador,ECU,11,0,11
2012,Finland,FIN,218,110,328
2012,France,FRA,640,0,640
2012,United Kingdom of Great Britain and Northern Ireland,GBR,1717,389,2106
2012,Georgia,GEO,140,16,156
2012,Germany,DEU,18165,5986,24151
2012,Greece,GRC,20,0,20
2012,Croatia,HRV,12,40,52
2012,Hungary,HUN,86,0,86
2012,India,IND,6,5,11
2012,Indonesia,IDN,5,48,53
2012,Ireland,IRL,38,11,49
2012,Iraq,IRQ,63586,1185,64771
2012,Italy,ITA,445,507,952
2012,Jordan,JOR,238798,491,239289
2012,Japan,JPN,0,18,18
2012,Kazakhstan,KAZ,0,14,14
2012,Kyrgyzstan,KGZ,7,34,41
2012,Rep. of Korea,KOR,0,146,146
2012,Kuwait,KWT,15,8,23
2012,Libya,LBY,0,3794,3794
2012,Lebanon,LBN,126939,242,127181
2012,Lithuania,LTU,5,5,10
2012,Latvia,LVA,17,15,32
2012,Rep. of Moldova,MDA,55,33,88
2012,Malaysia,MYS,5,83,88
2012,Montenegro,MNE,0,7,7
2012,Morocco,MAR,0,842,842
2012,Malta,MLT,191,139,330
2012,Netherlands,NLD,1449,231,1680
2012,Niger,NER,0,6,6
2012,Norway,NOR,565,306,871
2012,New Zealand,NZL,41,5,46
2012,Oman,OMN,7,5,12
2012,Pakistan,PAK,11,0,11
2012,Philippines,PHL,0,5,5
2012,Poland,POL,17,83,100
2012,Portugal,PRT,0,9,9
2012,Qatar,QAT,8,0,8
2012,Romania,ROU,152,10,162
2012,South Africa,ZAF,0,8,8
2012,Russian Federation,RUS,53,91,144
2012,Saudi Arabia,SAU,14,12,26
2012,Spain,ESP,32,320,352
2012,Serbia and Kosovo: S/RES/1244 (1999),SRB,0,49,49
2012,Sudan,SDN,0,32,32
2012,Slovakia,SVK,24,0,24
2012,Slovenia,SVN,0,8,8
2012,Sweden,SWE,6051,3751,9802
2012,Switzerland,CHE,1391,1692,3083
2012,Thailand,THA,10,60,70
2012,Togo,TGO,0,8,8
2012,Tunisia,TUN,6,30,36
2012,Turkey,TUR,248466,200,248666
2012,United Arab Emirates,ARE,16,14,30
2012,Ukraine,UKR,63,453,516
2012,United States of America,USA,1425,367,1792
2012,Yemen,YEM,42,131,173
2013,Albania,ALB,0,15,15
2013,Algeria,DZA,0,1079,1079
2013,Egypt,EGY,131659,0,131659
2013,Argentina,ARG,159,12,171
2013,Armenia,ARM,11090,42,11132
2013,Australia,AUS,265,138,403
2013,Austria,AUT,2748,1561,4309
2013,Azerbaijan,AZE,9,5,14
2013,Belgium,BEL,1987,378,2365
2013,Belarus,BLR,35,25,60
2013,Bolivia (Plurinational State of),BOL,5,0,5
2013,Brazil,BRA,333,70,403
2013,Bosnia and Herzegovina,BIH,48,18,66
2013,Bulgaria,BGR,2104,2500,4604
2013,Canada,CAN,592,435,1027
2013,Chad,TCD,15,0,15
2013,Chile,CHL,5,5,10
2013,Cameroon,CMR,0,7,7
2013,Costa Rica,CRI,0,5,5
2013,Cuba,CUB,24,0,24
2013,Cyprus,CYP,316,1319,1635
2013,Czechia,CZE,149,25,174
2013,Denmark,DNK,3271,86,3357
2013,Dominican Rep.,DOM,5,0,5
2013,Ecuador,ECU,11,5,16
2013,Estonia,EST,0,10,10
2013,Finland,FIN,352,77,429
2013,France,FRA,1474,343,1817
2013,United Kingdom of Great Britain and Northern Ireland,GBR,3169,641,3810
2013,Georgia,GEO,516,26,542
2013,Germany,DEU,21253,10566,31819
2013,Ghana,GHA,0,55,55
2013,Greece,GRC,195,1665,1860
2013,Croatia,HRV,22,36,58
2013,Hungary,HUN,141,184,325
2013,Iceland,ISL,7,10,17
2013,Cote d'Ivoire,CIV,0,12,12
2013,India,IND,18,12,30
2013,Indonesia,IDN,36,43,79
2013,Ireland,IRL,71,13,84
2013,Iraq,IRQ,212809,1164,213973
2013,Italy,ITA,840,278,1118
2013,Jordan,JOR,585304,0,585304
2013,Japan,JPN,26,0,26
2013,Kazakhstan,KAZ,7,21,28
2013,Kyrgyzstan,KGZ,14,78,92
2013,Rep. of Korea,KOR,0,431,431
2013,Kuwait,KWT,13,8,21
2013,Liberia,LBR,0,8,8
2013,Libya,LBY,16796,0,16796
2013,Lebanon,LBN,851284,332,851616
2013,Lithuania,LTU,18,5,23
2013,Luxembourg,LUX,5,23,28
2013,Latvia,LVA,33,12,45
2013,Mauritania,MRT,5,41,46
2013,North Macedonia,MKD,0,205,205
2013,Rep. of Moldova,MDA,139,27,166
2013,Mexico,MEX,13,0,13
2013,Malaysia,MYS,101,720,821
2013,Montenegro,MNE,0,60,60
2013,Mongolia,MNG,0,5,5
2013,Morocco,MAR,856,0,856
2013,Malta,MLT,776,102,878
2013,Netherlands,NLD,3404,0,3404
2013,Niger,NER,6,0,6
2013,Nigeria,NGA,9,10,19
2013,Norway,NOR,1311,259,1570
2013,New Zealand,NZL,43,7,50
2013,Oman,OMN,7,5,12
2013,Pakistan,PAK,13,0,13
2013,Peru,PER,5,0,5
2013,Philippines,PHL,7,21,28
2013,Poland,POL,108,100,208
2013,Portugal,PRT,14,8,22
2013,Qatar,QAT,8,0,8
2013,Romania,ROU,932,91,1023
2013,South Africa,ZAF,8,10,18
2013,Russian Federation,RUS,1163,839,2002
2013,Saudi Arabia,SAU,14,12,26
2013,Senegal,SEN,0,5,5
2013,Somalia,SOM,0,8,8
2013,Spain,ESP,180,743,923
2013,Serbia and Kosovo: S/RES/1244 (1999),SRB,5,60,65
2013,Sudan,SDN,84,224,308
2013,Slovakia,SVK,26,0,26
2013,Slovenia,SVN,9,0,9
2013,Sweden,SWE,17984,6808,24792
2013,Switzerland,CHE,2012,2849,4861
2013,United Rep. of Tanzania,TZA,0,6,6
2013,Thailand,THA,44,144,188
2013,Tunisia,TUN,164,0,164
2013,Turkey,TUR,585601,110,585711
2013,United Arab Emirates,ARE,16,14,30
2013,Uganda,UGA,0,8,8
2013,Ukraine,UKR,167,591,758
2013,United States of America,USA,3802,1378,5180
2013,Yemen,YEM,54,1761,1815
2013,Zambia,ZMB,0,5,5
2014,Albania,ALB,5,8,13
2014,Algeria,DZA,0,4108,4108
2014,Egypt,EGY,138381,0,138381
2014,Argentina,ARG,233,22,255
2014,Armenia,ARM,14994,9,15003
2014,Australia,AUS,302,172,474
2014,Austria,AUT,6653,0,6653
2014,Azerbaijan,AZE,7,7,14
2014,Belgium,BEL,2620,733,3353
2014,Belarus,BLR,72,48,120
2014,Bolivia (Plurinational State of),BOL,6,0,6
2014,Brazil,BRA,1739,76,1815
2014,Bosnia and Herzegovina,BIH,25,0,25
2014,Bulgaria,BGR,8501,2510,11011
2014,Canada,CAN,705,184,889
2014,Central African Rep.,CAF,0,8,8
2014,Chad,TCD,15,5,20
2014,China,CHN,5,0,5
2014,Chile,CHL,6,10,16
2014,Cameroon,CMR,0,11,11
2014,Colombia,COL,5,0,5
2014,Costa Rica,CRI,5,5,10
2014,Cuba,CUB,20,0,20
2014,Cyprus,CYP,1451,1110,2561
2014,Czechia,CZE,236,54,290
2014,Denmark,DNK,7253,1468,8721
2014,Djibouti,DJI,0,5,5
2014,Ecuador,ECU,13,0,13
2014,Estonia,EST,6,5,11
2014,Ethiopia,ETH,0,8,8
2014,Finland,FIN,438,55,493
2014,France,FRA,2882,1239,4121
2014,United Kingdom of Great Britain and Northern Ireland,GBR,4573,1329,5902
2014,Georgia,GEO,471,35,506
2014,Germany,DEU,40994,29591,70585
2014,Ghana,GHA,5,73,78
2014,Greece,GRC,3913,182,4095
2014,Croatia,HRV,22,6,28
2014,Hungary,HUN,334,823,1157
2014,Iceland,ISL,7,5,12
2014,Cote d'Ivoire,CIV,5,16,21
2014,India,IND,27,18,45
2014,Indonesia,IDN,43,42,85
2014,Ireland,IRL,176,12,188
2014,Iraq,IRQ,234196,1225,235421
2014,Italy,ITA,1144,331,1475
2014,Jamaica,JAM,5,0,5
2014,Jordan,JOR,623112,0,623112
2014,Japan,JPN,41,12,53
2014,Kazakhstan,KAZ,14,29,43
2014,Kenya,KEN,0,5,5
2014,Kyrgyzstan,KGZ,56,16,72
2014,Rep. of Korea,KOR,503,64,567
2014,Kuwait,KWT,15,7,22
2014,Liberia,LBR,6,0,6
2014,Libya,LBY,18653,0,18653
2014,Lebanon,LBN,1147494,418,1147912
2014,Liechtenstein,LIE,5,0,5
2014,Sri Lanka,LKA,5,5,10
2014,Lithuania,LTU,20,5,25
2014,Luxembourg,LUX,59,59,118
2014,Latvia,LVA,52,17,69
2014,Mauritania,MRT,41,54,95
2014,North Macedonia,MKD,11,654,665
2014,Rep. of Moldova,MDA,186,22,208
2014,Mexico,MEX,13,6,19
2014,Mali,MLI,16,0,16
2014,Malaysia,MYS,447,530,977
2014,Montenegro,MNE,0,36,36
2014,Mongolia,MNG,5,0,5
2014,Morocco,MAR,647,0,647
2014,Malta,MLT,1047,34,1081
2014,Netherlands,NLD,8692,2323,11015
2014,Niger,NER,6,0,6
2014,Nigeria,NGA,11,17,28
2014,Norway,NOR,2568,828,3396
2014,Nauru,NRU,0,5,5
2014,New Zealand,NZL,48,6,54
2014,Oman,OMN,7,6,13
2014,Pakistan,PAK,16,0,16
2014,Paraguay,PRY,7,9,16
2014,Peru,PER,20,0,20
2014,Philippines,PHL,19,35,54
2014,Poland,POL,240,34,274
2014,Portugal,PRT,15,15,30
2014,Qatar,QAT,14,0,14
2014,Romania,ROU,1278,112,1390
2014,South Africa,ZAF,28,36,64
2014,Russian Federation,RUS,1927,413,2340
2014,Saudi Arabia,SAU,18,12,30
2014,Senegal,SEN,0,21,21
2014,Somalia,SOM,0,63,63
2014,Spain,ESP,1336,781,2117
2014,Serbia and Kosovo: S/RES/1244 (1999),SRB,6,238,244
2014,Sudan,SDN,797,238,1035
2014,Slovakia,SVK,40,0,40
2014,Slovenia,SVN,20,8,28
2014,Sweden,SWE,34285,19011,53296
2014,Switzerland,CHE,5161,3501,8662
2014,Thailand,THA,82,168,250
2014,Togo,TGO,0,6,6
2014,Trinidad and Tobago,TTO,8,13,21
2014,Tunisia,TUN,558,0,558
2014,Turkey,TUR,1557899,250,1558149
2014,United Arab Emirates,ARE,28,12,40
2014,Uganda,UGA,0,13,13
2014,Ukraine,UKR,341,593,934
2014,Uruguay,URY,48,11,59
2014,United States of America,USA,4750,2302,7052
2014,Yemen,YEM,2276,1039,3315
2014,Zambia,ZMB,0,9,9
2015,Albania,ALB,5,0,5
2015,Algeria,DZA,0,6211,6211
2015,Antigua and Barbuda,ATG,15,0,15
2015,Egypt,EGY,117635,0,117635
2015,Argentina,ARG,276,98,374
2015,Armenia,ARM,16611,11,16622
2015,Australia,AUS,301,134,435
2015,Austria,AUT,14894,18669,33563
2015,Azerbaijan,AZE,8,7,15
2015,Belgium,BEL,4239,3870,8109
2015,Belarus,BLR,138,7,145
2015,Bolivia (Plurinational State of),BOL,7,0,7
2015,Brazil,BRA,2271,1154,3425
2015,Bosnia and Herzegovina,BIH,14,5,19
2015,Bulgaria,BGR,13819,1683,15502
2015,Canada,CAN,1513,235,1748
2015,Central African Rep.,CAF,0,8,8
2015,Chad,TCD,6,22,28
2015,China,CHN,14,24,38
2015,Chile,CHL,13,11,24
2015,Cameroon,CMR,15,7,22
2015,Congo,COG,5,5,10
2015,Dem. Rep. of the Congo,COD,7,0,7
2015,Colombia,COL,7,0,7
2015,Costa Rica,CRI,8,0,8
2015,Cuba,CUB,41,0,41
2015,Curacao ,CUW,0,5,5
2015,Cyprus,CYP,3110,692,3802
2015,Czechia,CZE,365,42,407
2015,Denmark,DNK,12988,825,13813
2015,Djibouti,DJI,5,0,5
2015,Ecuador,ECU,17,0,17
2015,Estonia,EST,6,0,6
2015,Ethiopia,ETH,9,15,24
2015,Finland,FIN,565,705,1270
2015,France,FRA,5179,2711,7890
2015,United Kingdom of Great Britain and Northern Ireland,GBR,6496,1648,8144
2015,Georgia,GEO,475,10,485
2015,Germany,DEU,115604,81582,197186
2015,Ghana,GHA,47,49,96
2015,Greece,GRC,9101,450,9551
2015,Croatia,HRV,23,5,28
2015,Hungary,HUN,476,18607,19083
2015,Iceland,ISL,37,0,37
2015,Cote d'Ivoire,CIV,20,8,28
2015,India,IND,41,20,61
2015,Indonesia,IDN,61,32,93
2015,Ireland,IRL,109,50,159
2015,Iraq,IRQ,244642,0,244642
2015,Italy,ITA,1460,246,1706
2015,Jamaica,JAM,5,0,5
2015,Jordan,JOR,628223,0,628223
2015,Japan,JPN,59,0,59
2015,Kazakhstan,KAZ,23,16,39
2015,Kenya,KEN,9,8,17
2015,Kyrgyzstan,KGZ,55,12,67
2015,Rep. of Korea,KOR,646,320,966
2015,Kuwait,KWT,14,6,20
2015,Liberia,LBR,6,5,11
2015,Libya,LBY,97,18591,18688
2015,Lebanon,LBN,1062690,16,1062706
2015,Liechtenstein,LIE,23,0,23
2015,Sri Lanka,LKA,5,11,16
2015,Lithuania,LTU,23,5,28
2015,Luxembourg,LUX,177,593,770
2015,Latvia,LVA,65,5,70
2015,Mauritania,MRT,215,107,322
2015,North Macedonia,MKD,13,5,18
2015,Rep. of Moldova,MDA,206,8,214
2015,Mexico,MEX,18,0,18
2015,Mali,MLI,82,9,91
2015,Malaysia,MYS,473,829,1302
2015,Morocco,MAR,2619,0,2619
2015,Malta,MLT,1328,161,1489
2015,Netherlands,NLD,16184,12718,28902
2015,Niger,NER,6,0,6
2015,Nigeria,NGA,32,41,73
2015,Norway,NOR,4121,9128,13249
2015,Nauru,NRU,0,5,5
2015,New Zealand,NZL,52,5,57
2015,Oman,OMN,7,5,12
2015,Pakistan,PAK,16,9,25
2015,Paraguay,PRY,30,27,57
2015,Peru,PER,29,0,29
2015,Philippines,PHL,36,40,76
2015,Poland,POL,445,36,481
2015,Portugal,PRT,17,28,45
2015,Qatar,QAT,14,0,14
2015,Romania,ROU,1591,96,1687
2015,South Africa,ZAF,31,58,89
2015,Russian Federation,RUS,1304,393,1697
2015,El Salvador,SLV,5,0,5
2015,Saudi Arabia,SAU,9,0,9
2015,Senegal,SEN,0,21,21
2015,Somalia,SOM,24,101,125
2015,Spain,ESP,1992,3280,5272
2015,Serbia and Kosovo: S/RES/1244 (1999),SRB,11,0,11
2015,Sudan,SDN,2692,527,3219
2015,Slovakia,SVK,47,0,47
2015,Slovenia,SVN,30,9,39
2015,Sweden,SWE,52707,49286,101993
2015,Switzerland,CHE,8695,4462,13157
2015,Sint Maarten (Dutch part),SXM,0,5,5
2015,Thailand,THA,95,243,338
2015,Togo,TGO,5,6,11
2015,Trinidad and Tobago,TTO,22,25,47
2015,Tunisia,TUN,499,0,499
2015,Turkey,TUR,2503549,297,2503846
2015,United Arab Emirates,ARE,36,109,145
2015,Uganda,UGA,6,11,17
2015,Ukraine,UKR,399,566,965
2015,Uruguay,URY,58,9,67
2015,United States of America,USA,5651,3118,8769
2015,Yemen,YEM,3011,615,3626
2015,Zambia,ZMB,6,8,14
2016,Albania,ALB,5,0,5
2016,Algeria,DZA,0,5329,5329
2016,Antigua and Barbuda,ATG,5,0,5
2016,Egypt,EGY,116013,0,116013
2016,Argentina,ARG,357,53,410
2016,Armenia,ARM,14626,20,14646
2016,Australia,AUS,378,134,512
2016,Austria,AUT,30958,9812,40770
2016,Azerbaijan,AZE,15,8,23
2016,Belgium,BEL,9080,1798,10878
2016,Benin,BEN,0,5,5
2016,Belarus,BLR,77,9,86
2016,Bolivia (Plurinational State of),BOL,13,0,13
2016,Brazil,BRA,2591,1209,3800
2016,Bosnia and Herzegovina,BIH,15,12,27
2016,Bulgaria,BGR,15027,1961,16988
2016,Canada,CAN,2757,380,3137
2016,Chad,TCD,17,9,26
2016,China,CHN,20,35,55
2016,Chile,CHL,18,15,33
2016,Cameroon,CMR,23,0,23
2016,Congo,COG,5,5,10
2016,Dem. Rep. of the Congo,COD,11,22,33
2016,Colombia,COL,8,5,13
2016,Costa Rica,CRI,8,5,13
2016,Cuba,CUB,39,5,44
2016,Cyprus,CYP,4263,824,5087
2016,Czechia,CZE,365,17,382
2016,Denmark,DNK,18215,512,18727
2016,Djibouti,DJI,13,0,13
2016,Dominican Rep.,DOM,0,5,5
2016,Estonia,EST,76,0,76
2016,Ethiopia,ETH,9,48,57
2016,Finland,FIN,1677,130,1807
2016,France,FRA,8991,2149,11140
2016,United Kingdom of Great Britain and Northern Ireland,GBR,8269,1010,9279
2016,Georgia,GEO,425,12,437
2016,Germany,DEU,375122,100527,475649
2016,Ghana,GHA,8,122,130
2016,Guinea-Bissau,GNB,0,5,5
2016,Greece,GRC,14420,13997,28417
2016,Croatia,HRV,60,130,190
2016,Hungary,HUN,584,864,1448
2016,Iceland,ISL,37,5,42
2016,Cote d'Ivoire,CIV,5,14,19
2016,India,IND,65,35,100
2016,Indonesia,IDN,30,36,66
2016,Ireland,IRL,243,135,378
2016,Iraq,IRQ,230836,0,230836
2016,Italy,ITA,2613,548,3161
2016,Jamaica,JAM,5,0,5
2016,Jordan,JOR,648836,0,648836
2016,Japan,JPN,61,0,61
2016,Kazakhstan,KAZ,19,22,41
2016,Kenya,KEN,0,7,7
2016,Kyrgyzstan,KGZ,66,6,72
2016,Rep. of Korea,KOR,876,244,1120
2016,Kuwait,KWT,50,24,74
2016,Liberia,LBR,6,5,11
2016,Libya,LBY,142,19366,19508
2016,Lebanon,LBN,1005503,10,1005513
2016,Liechtenstein,LIE,23,0,23
2016,Sri Lanka,LKA,8,6,14
2016,Lithuania,LTU,161,28,189
2016,Luxembourg,LUX,686,334,1020
2016,Latvia,LVA,143,78,221
2016,Mauritania,MRT,417,120,537
2016,North Macedonia,MKD,13,5,18
2016,Rep. of Moldova,MDA,218,12,230
2016,Mexico,MEX,23,0,23
2016,Mali,MLI,11,5,16
2016,Malaysia,MYS,458,986,1444
2016,Montenegro,MNE,10,0,10
2016,Morocco,MAR,3242,0,3242
2016,Malta,MLT,1668,121,1789
2016,Mauritius,MUS,0,5,5
2016,Netherlands,NLD,28394,987,29381
2016,Niger,NER,7,0,7
2016,Nigeria,NGA,88,47,135
2016,Norway,NOR,11537,1083,12620
2016,Nauru,NRU,0,5,5
2016,New Zealand,NZL,61,5,66
2016,Oman,OMN,7,6,13
2016,Pakistan,PAK,13,7,20
2016,Paraguay,PRY,51,21,72
2016,Peru,PER,32,7,39
2016,Philippines,PHL,51,40,91
2016,Poland,POL,483,18,501
2016,Portugal,PRT,82,300,382
2016,Qatar,QAT,32,5,37
2016,Romania,ROU,1775,21,1796
2016,South Africa,ZAF,44,49,93
2016,Russian Federation,RUS,1319,383,1702
2016,El Salvador,SLV,5,0,5
2016,Saudi Arabia,SAU,19,10,29
2016,Senegal,SEN,0,21,21
2016,Somalia,SOM,145,0,145
2016,Spain,ESP,8205,1600,9805
2016,Serbia and Kosovo: S/RES/1244 (1999),SRB,747,0,747
2016,South Sudan,SSD,5,0,5
2016,Sudan,SDN,6997,501,7498
2016,Slovakia,SVK,54,0,54
2016,Slovenia,SVN,118,41,159
2016,Sweden,SWE,96914,7085,103999
2016,Switzerland,CHE,11159,3858,15017
2016,Thailand,THA,268,42,310
2016,Togo,TGO,5,8,13
2016,Trinidad and Tobago,TTO,31,35,66
2016,Tunisia,TUN,504,0,504
2016,Turkey,TUR,2823987,180,2824167
2016,United Arab Emirates,ARE,119,165,284
2016,Uganda,UGA,7,12,19
2016,Ukraine,UKR,446,560,1006
2016,Uruguay,URY,60,5,65
2016,United States of America,USA,6444,3364,9808
2016,Venezuela (Bolivarian Republic of),VEN,5,18,23
2016,Yemen,YEM,3249,502,3751
2016,Zambia,ZMB,5,6,11
2017,Albania,ALB,5,22,27
2017,Algeria,DZA,8,5821,5829
2017,Egypt,EGY,126688,0,126688
2017,Argentina,ARG,370,84,454
2017,Armenia,ARM,14680,12,14692
2017,Australia,AUS,477,128,605
2017,Austria,AUT,43888,3937,47825
2017,Azerbaijan,AZE,15,0,15
2017,Belgium,BEL,9080,1665,10745
2017,Benin,BEN,7,5,12
2017,Belarus,BLR,87,0,87
2017,Bolivia (Plurinational State of),BOL,21,8,29
2017,Brazil,BRA,2905,4522,7427
2017,Bosnia and Herzegovina,BIH,15,13,28
2017,Bulgaria,BGR,16549,407,16956
2017,Canada,CAN,3095,807,3902
2017,Chad,TCD,39,29,68
2017,China,CHN,42,32,74
2017,Chile,CHL,85,42,127
2017,Cameroon,CMR,15,9,24
2017,Congo,COG,9,12,21
2017,Dem. Rep. of the Congo,COD,8,20,28
2017,Colombia,COL,8,5,13
2017,Costa Rica,CRI,9,9,18
2017,Cuba,CUB,43,0,43
2017,Cyprus,CYP,5274,1585,6859
2017,Czechia,CZE,365,38,403
2017,Denmark,DNK,19221,285,19506
2017,Djibouti,DJI,9,0,9
2017,Dominican Rep.,DOM,0,6,6
2017,Ecuador,ECU,39,115,154
2017,Estonia,EST,151,0,151
2017,Ethiopia,ETH,9,67,76
2017,Finland,FIN,2370,132,2502
2017,France,FRA,12520,2394,14914
2017,United Kingdom of Great Britain and Northern Ireland,GBR,9100,574,9674
2017,Georgia,GEO,445,9,454
2017,Germany,DEU,496674,70833,567507
2017,Ghana,GHA,39,150,189
2017,Greece,GRC,13714,9605,23319
2017,Croatia,HRV,194,77,271
2017,Hungary,HUN,925,108,1033
2017,Iceland,ISL,58,5,63
2017,Cote d'Ivoire,CIV,12,9,21
2017,India,IND,87,17,104
2017,Indonesia,IDN,35,27,62
2017,Ireland,IRL,718,138,856
2017,Iraq,IRQ,247057,0,247057
2017,Italy,ITA,3618,1696,5314
2017,Jamaica,JAM,5,0,5
2017,Jordan,JOR,653031,0,653031
2017,Japan,JPN,66,0,66
2017,Kazakhstan,KAZ,17,23,40
2017,Kenya,KEN,0,7,7
2017,Kyrgyzstan,KGZ,69,12,81
2017,Rep. of Korea,KOR,1122,68,1190
2017,Kuwait,KWT,44,31,75
2017,Liberia,LBR,7,6,13
2017,Libya,LBY,257,21890,22147
2017,Lebanon,LBN,992127,10,992137
2017,Liechtenstein,LIE,32,0,32
2017,Sri Lanka,LKA,14,0,14
2017,Lithuania,LTU,362,52,414
2017,Luxembourg,LUX,686,225,911
2017,Latvia,LVA,393,0,393
2017,Mauritania,MRT,464,112,576
2017,North Macedonia,MKD,15,5,20
2017,Rep. of Moldova,MDA,204,18,222
2017,Mexico,MEX,23,0,23
2017,Mali,MLI,9,0,9
2017,Malaysia,MYS,372,1937,2309
2017,Montenegro,MNE,0,47,47
2017,Morocco,MAR,2953,0,2953
2017,Malta,MLT,1289,252,1541
2017,Mauritius,MUS,5,0,5
2017,Netherlands,NLD,30851,668,31519
2017,Niger,NER,7,0,7
2017,Nigeria,NGA,154,60,214
2017,Norway,NOR,13349,447,13796
2017,New Zealand,NZL,65,5,70
2017,Oman,OMN,7,6,13
2017,Pakistan,PAK,29,0,29
2017,Panama,PAN,0,11,11
2017,Paraguay,PRY,53,26,79
2017,Peru,PER,38,5,43
2017,Philippines,PHL,74,40,114
2017,Poland,POL,512,18,530
2017,Portugal,PRT,307,0,307
2017,Qatar,QAT,34,0,34
2017,Romania,ROU,2282,167,2449
2017,South Africa,ZAF,45,0,45
2017,Russian Federation,RUS,1130,303,1433
2017,El Salvador,SLV,5,0,5
2017,Saudi Arabia,SAU,14,34,48
2017,Senegal,SEN,0,21,21
2017,Somalia,SOM,172,5,177
2017,Spain,ESP,11752,2255,14007
2017,Serbia and Kosovo: S/RES/1244 (1999),SRB,73,0,73
2017,Sudan,SDN,11240,439,11679
2017,Slovakia,SVK,17,0,17
2017,Slovenia,SVN,215,9,224
2017,Sweden,SWE,103614,3531,107145
2017,Switzerland,CHE,13639,3192,16831
2017,Thailand,THA,327,9,336
2017,Togo,TGO,0,9,9
2017,Trinidad and Tobago,TTO,53,32,85
2017,Tunisia,TUN,603,0,603
2017,Turkey,TUR,3424237,162,3424399
2017,United Arab Emirates,ARE,128,1185,1313
2017,Uganda,UGA,7,12,19
2017,Ukraine,UKR,483,520,1003
2017,Uruguay,URY,61,0,61
2017,United States of America,USA,7282,3358,10640
2017,Venezuela (Bolivarian Republic of),VEN,5,0,5
2017,Yemen,YEM,3286,496,3782
2018,Albania,ALB,6,44,50
2018,Algeria,DZA,14,7485,7499
2018,Egypt,EGY,132871,0,132871
2018,Argentina,ARG,385,95,480
2018,Armenia,ARM,14701,8,14709
2018,Australia,AUS,582,100,682
2018,Austria,AUT,49179,1538,50717
2018,Azerbaijan,AZE,15,5,20
2018,Belgium,BEL,9080,2005,11085
2018,Benin,BEN,12,0,12
2018,Belarus,BLR,66,5,71
2018,Bolivia (Plurinational State of),BOL,21,8,29
2018,Brazil,BRA,3455,4270,7725
2018,Bosnia and Herzegovina,BIH,15,67,82
2018,Bulgaria,BGR,17161,215,17376
2018,Canada,CAN,3558,803,4361
2018,Chad,TCD,57,14,71
2018,China,CHN,53,19,72
2018,Chile,CHL,107,36,143
2018,Cameroon,CMR,22,6,28
2018,Congo,COG,12,19,31
2018,Dem. Rep. of the Congo,COD,5,20,25
2018,Colombia,COL,8,8,16
2018,Costa Rica,CRI,9,12,21
2018,Cuba,CUB,44,5,49
2018,Cyprus,CYP,6259,2553,8812
2018,Czechia,CZE,448,8,456
2018,Denmark,DNK,19698,292,19990
2018,Djibouti,DJI,10,0,10
2018,Ecuador,ECU,102,90,192
2018,Estonia,EST,146,0,146
2018,Ethiopia,ETH,9,70,79
2018,Finland,FIN,2497,73,2570
2018,France,FRA,15822,3352,19174
2018,United Kingdom of Great Britain and Northern Ireland,GBR,9720,685,10405
2018,Georgia,GEO,428,24,452
2018,Germany,DEU,532065,52396,584461
2018,Ghana,GHA,157,85,242
2018,Greece,GRC,23931,14104,38035
2018,Guinea,GIN,5,5,10
2018,Croatia,HRV,398,29,427
2018,Hungary,HUN,971,5,976
2018,Iceland,ISL,87,30,117
2018,Cote d'Ivoire,CIV,92,8,100
2018,India,IND,83,17,100
2018,Indonesia,IDN,29,18,47
2018,Ireland,IRL,2126,66,2192
2018,Iraq,IRQ,252526,0,252526
2018,Italy,ITA,4652,1197,5849
2018,Jamaica,JAM,5,0,5
2018,Jordan,JOR,676283,0,676283
2018,Japan,JPN,69,0,69
2018,Kazakhstan,KAZ,15,14,29
2018,Kenya,KEN,0,11,11
2018,Kyrgyzstan,KGZ,77,14,91
2018,Rep. of Korea,KOR,1177,59,1236
2018,Kuwait,KWT,73,50,123
2018,Liberia,LBR,10,5,15
2018,Libya,LBY,552,23173,23725
2018,Lebanon,LBN,944181,5,944186
2018,Liechtenstein,LIE,32,0,32
2018,Sri Lanka,LKA,14,0,14
2018,Lithuania,LTU,435,10,445
2018,Luxembourg,LUX,686,160,846
2018,Latvia,LVA,384,0,384
2018,Mauritania,MRT,332,47,379
2018,North Macedonia,MKD,17,0,17
2018,Rep. of Moldova,MDA,213,5,218
2018,Mexico,MEX,28,5,33
2018,Mali,MLI,9,330,339
2018,Malaysia,MYS,421,2406,2827
2018,Montenegro,MNE,5,47,52
2018,Morocco,MAR,3506,0,3506
2018,Malta,MLT,1497,370,1867
2018,Mauritius,MUS,5,0,5
2018,Netherlands,NLD,32092,1687,33779
2018,Niger,NER,11,5,16
2018,Nigeria,NGA,224,75,299
2018,Norway,NOR,13914,235,14149
2018,Nauru,NRU,0,5,5
2018,New Zealand,NZL,68,0,68
2018,Oman,OMN,7,0,7
2018,Pakistan,PAK,29,6,35
2018,Panama,PAN,0,12,12
2018,Paraguay,PRY,63,22,85
2018,Peru,PER,44,7,51
2018,Philippines,PHL,105,33,138
2018,Poland,POL,531,20,551
2018,Portugal,PRT,602,0,602
2018,Qatar,QAT,34,0,34
2018,Romania,ROU,2292,150,2442
2018,South Africa,ZAF,45,7,52
2018,Russian Federation,RUS,828,174,1002
2018,El Salvador,SLV,5,0,5
2018,Saudi Arabia,SAU,103,2063,2166
2018,Senegal,SEN,0,14,14
2018,Somalia,SOM,206,14,220
2018,Spain,ESP,13765,2320,16085
2018,Serbia and Kosovo: S/RES/1244 (1999),SRB,74,7,81
2018,Sudan,SDN,93502,0,93502
2018,Slovakia,SVK,14,0,14
2018,Slovenia,SVN,290,23,313
2018,Sweden,SWE,109343,2353,111696
2018,Switzerland,CHE,16565,1789,18354
2018,Thailand,THA,276,7,283
2018,Togo,TGO,0,9,9
2018,Trinidad and Tobago,TTO,57,37,94
2018,Tunisia,TUN,927,0,927
2018,Turkey,TUR,3622366,111,3622477
2018,United Arab Emirates,ARE,287,5820,6107
2018,Uganda,UGA,5,5,10
2018,Ukraine,UKR,457,489,946
2018,Uruguay,URY,61,0,61
2018,United States of America,USA,7998,3057,11055
2018,Venezuela (Bolivarian Republic of),VEN,5,0,5
2018,Yemen,YEM,3446,406,3852
2018,Zambia,ZMB,8,9,17
2019,Albania,ALB,13,0,13
2019,Algeria,DZA,7757,0,7757
2019,Egypt,EGY,129210,0,129210
2019,Argentina,ARG,401,73,474
2019,Armenia,ARM,14730,16,14746
2019,Australia,AUS,613,79,692
2019,Austria,AUT,51955,1304,53259
2019,Azerbaijan,AZE,20,0,20
2019,Belgium,BEL,16604,1019,17623
2019,Benin,BEN,12,13,25
2019,Burkina Faso,BFA,5,0,5
2019,Belarus,BLR,68,0,68
2019,Bolivia (Plurinational State of),BOL,21,0,21
2019,Brazil,BRA,3761,4242,8003
2019,Bosnia and Herzegovina,BIH,21,46,67
2019,Bulgaria,BGR,17551,297,17848
2019,Canada,CAN,5,303,308
2019,Chad,TCD,35,8,43
2019,China,CHN,50,13,63
2019,Chile,CHL,112,33,145
2019,Cameroon,CMR,24,5,29
2019,Congo,COG,0,13,13
2019,Dem. Rep. of the Congo,COD,5,26,31
2019,Colombia,COL,8,8,16
2019,Costa Rica,CRI,5,24,29
2019,Cuba,CUB,40,0,40
2019,Cyprus,CYP,7372,4073,11445
2019,Czechia,CZE,408,18,426
2019,Denmark,DNK,20046,210,20256
2019,Djibouti,DJI,10,0,10
2019,Ecuador,ECU,146,38,184
2019,Estonia,EST,127,0,127
2019,Ethiopia,ETH,0,410,410
2019,Finland,FIN,2585,77,2662
2019,France,FRA,18244,3244,21488
2019,United Kingdom of Great Britain and Northern Ireland,GBR,10389,1228,11617
2019,Georgia,GEO,91,26,117
2019,Germany,DEU,572818,41280,614098
2019,Ghana,GHA,167,113,280
2019,Greece,GRC,26696,16165,42861
2019,Guinea,GIN,14,0,14
2019,Croatia,HRV,527,10,537
2019,Hungary,HUN,934,7,941
2019,Iceland,ISL,109,19,128
2019,Cote d'Ivoire,CIV,132,11,143
2019,India,IND,70,29,99
2019,Indonesia,IDN,23,19,42
2019,Ireland,IRL,2882,54,2936
2019,Iraq,IRQ,245810,0,245810
2019,Italy,ITA,4781,917,5698
2019,Jordan,JOR,654692,0,654692
2019,Japan,JPN,69,0,69
2019,Kazakhstan,KAZ,14,19,33
2019,Kenya,KEN,5,5,10
2019,Kyrgyzstan,KGZ,86,5,91
2019,Rep. of Korea,KOR,1199,60,1259
2019,Kuwait,KWT,106,100,206
2019,Liberia,LBR,11,0,11
2019,Libya,LBY,612,16738,17350
2019,Lebanon,LBN,910586,0,910586
2019,Liechtenstein,LIE,32,0,32
2019,Sri Lanka,LKA,5,0,5
2019,Lithuania,LTU,453,6,459
2019,Luxembourg,LUX,951,200,1151
2019,Latvia,LVA,354,0,354
2019,Madagascar,MDG,5,0,5
2019,Mauritania,MRT,355,36,391
2019,North Macedonia,MKD,17,14,31
2019,Rep. of Moldova,MDA,210,5,215
2019,Mexico,MEX,29,8,37
2019,Mali,MLI,20,413,433
2019,Malaysia,MYS,425,2861,3286
2019,Montenegro,MNE,0,14,14
2019,Morocco,MAR,3676,0,3676
2019,Malta,MLT,1706,482,2188
2019,Netherlands,NLD,31694,3092,34786
2019,Niger,NER,7,0,7
2019,Nigeria,NGA,263,132,395
2019,Norway,NOR,14359,252,14611
2019,Nauru,NRU,0,5,5
2019,New Zealand,NZL,69,5,74
2019,Oman,OMN,8,0,8
2019,Pakistan,PAK,43,0,43
2019,Panama,PAN,0,12,12
2019,Paraguay,PRY,88,11,99
2019,Peru,PER,42,12,54
2019,Philippines,PHL,115,41,156
2019,Poland,POL,542,23,565
2019,Portugal,PRT,768,5,773
2019,Qatar,QAT,34,0,34
2019,Romania,ROU,2090,146,2236
2019,South Africa,ZAF,40,20,60
2019,Russian Federation,RUS,593,110,703
2019,El Salvador,SLV,5,0,5
2019,Saudi Arabia,SAU,152,2220,2372
2019,Senegal,SEN,0,14,14
2019,Somalia,SOM,245,21,266
2019,Spain,ESP,14133,2805,16938
2019,Serbia and Kosovo: S/RES/1244 (1999),SRB,25,25,50
2019,Sudan,SDN,93495,0,93495
2019,Slovakia,SVK,14,5,19
2019,Slovenia,SVN,307,15,322
2019,Sweden,SWE,113418,2226,115644
2019,Switzerland,CHE,18755,918,19673
2019,United Rep. of Tanzania,TZA,5,16,21
2019,Thailand,THA,217,8,225
2019,Togo,TGO,6,11,17
2019,Trinidad and Tobago,TTO,58,38,96
2019,Tunisia,TUN,1382,0,1382
2019,Turkey,TUR,3576370,0,3576370
2019,United Arab Emirates,ARE,333,6575,6908
2019,Uganda,UGA,6,10,16
2019,Ukraine,UKR,462,161,623
2019,Uruguay,URY,61,7,68
2019,United States of America,USA,8449,2660,11109
2019,Venezuela (Bolivarian Republic of),VEN,5,0,5
2019,Yemen,YEM,3551,407,3958
2019,Zambia,ZMB,15,6,21
2020,Albania,ALB,9,0,9
2020,Algeria,DZA,6627,0,6627
2020,Angola,AGO,0,5,5
2020,Egypt,EGY,130577,0,130577
2020,Argentina,ARG,407,83,490
2020,Armenia,ARM,14741,5,14746
2020,Australia,AUS,645,58,703
2020,Austria,AUT,54903,2820,57723
2020,Azerbaijan,AZE,34,0,34
2020,Bahrain,BHR,0,23,23
2020,Belgium,BEL,17693,2165,19858
2020,Benin,BEN,22,9,31
2020,Burkina Faso,BFA,5,0,5
2020,Belarus,BLR,64,8,72
2020,Bolivia (Plurinational State of),BOL,22,0,22
2020,Brazil,BRA,3924,4086,8010
2020,Bosnia and Herzegovina,BIH,22,10,32
2020,Bulgaria,BGR,18310,593,18903
2020,Canada,CAN,131,180,311
2020,Chad,TCD,32,6,38
2020,China,CHN,41,13,54
2020,Chile,CHL,113,32,145
2020,Cameroon,CMR,24,5,29
2020,Congo,COG,5,13,18
2020,Dem. Rep. of the Congo,COD,8,13,21
2020,Colombia,COL,8,8,16
2020,Costa Rica,CRI,5,21,26
2020,Cuba,CUB,40,5,45
2020,Cyprus,CYP,8797,4415,13212
2020,Czechia,CZE,386,12,398
2020,Denmark,DNK,19878,281,20159
2020,Djibouti,DJI,10,0,10
2020,Ecuador,ECU,142,29,171
2020,Estonia,EST,105,0,105
2020,Ethiopia,ETH,6,424,430
2020,Finland,FIN,2620,84,2704
2020,France,FRA,21849,2587,24436
2020,United Kingdom of Great Britain and Northern Ireland,GBR,10919,2231,13150
2020,Georgia,GEO,437,20,457
2020,Germany,DEU,605338,37219,642557
2020,Ghana,GHA,230,48,278
2020,Greece,GRC,36448,5965,42413
2020,Guinea,GIN,17,12,29
2020,Croatia,HRV,539,26,565
2020,Hungary,HUN,923,0,923
2020,Iceland,ISL,167,5,172
2020,Cote d'Ivoire,CIV,142,9,151
2020,India,IND,63,57,120
2020,Indonesia,IDN,23,21,44
2020,Ireland,IRL,3126,67,3193
2020,Iraq,IRQ,242163,0,242163
2020,Italy,ITA,3508,1037,4545
2020,Jordan,JOR,662790,0,662790
2020,Japan,JPN,73,0,73
2020,Kazakhstan,KAZ,14,18,32
2020,Kenya,KEN,5,5,10
2020,Kyrgyzstan,KGZ,78,8,86
2020,Rep. of Korea,KOR,1236,35,1271
2020,Kuwait,KWT,139,77,216
2020,Liberia,LBR,12,15,27
2020,Libya,LBY,717,13819,14536
2020,Lebanon,LBN,865300,0,865300
2020,Liechtenstein,LIE,32,0,32
2020,Sri Lanka,LKA,5,0,5
2020,Lithuania,LTU,463,5,468
2020,Luxembourg,LUX,2069,340,2409
2020,Latvia,LVA,314,5,319
2020,Madagascar,MDG,5,0,5
2020,Mauritania,MRT,364,55,419
2020,North Macedonia,MKD,17,5,22
2020,Rep. of Moldova,MDA,190,5,195
2020,Mexico,MEX,30,14,44
2020,Mali,MLI,20,434,454
2020,Malaysia,MYS,407,2850,3257
2020,Montenegro,MNE,0,9,9
2020,Morocco,MAR,4528,0,4528
2020,Malta,MLT,1871,381,2252
2020,Netherlands,NLD,35810,2280,38090
2020,Niger,NER,5,0,5
2020,Nigeria,NGA,308,216,524
2020,Norway,NOR,15311,340,15651
2020,Nauru,NRU,0,5,5
2020,New Zealand,NZL,72,0,72
2020,Oman,OMN,8,22,30
2020,Pakistan,PAK,43,0,43
2020,Paraguay,PRY,88,17,105
2020,Peru,PER,42,14,56
2020,Philippines,PHL,134,40,174
2020,Poland,POL,237,39,276
2020,Portugal,PRT,789,0,789
2020,Qatar,QAT,34,89,123
2020,Romania,ROU,2002,215,2217
2020,South Africa,ZAF,38,20,58
2020,Russian Federation,RUS,361,54,415
2020,El Salvador,SLV,5,0,5
2020,Saudi Arabia,SAU,173,7671,7844
2020,Senegal,SEN,0,14,14
2020,Somalia,SOM,603,15,618
2020,Spain,ESP,14660,1545,16205
2020,Serbia and Kosovo: S/RES/1244 (1999),SRB,31,40,71
2020,Sudan,SDN,93498,0,93498
2020,Slovakia,SVK,21,5,26
2020,Slovenia,SVN,322,16,338
2020,Sweden,SWE,114609,1544,116153
2020,Switzerland,CHE,19869,236,20105
2020,United Rep. of Tanzania,TZA,5,17,22
2020,Thailand,THA,226,6,232
2020,Togo,TGO,16,6,22
2020,Trinidad and Tobago,TTO,66,38,104
2020,Tunisia,TUN,1997,0,1997
2020,Turkey,TUR,3641370,0,3641370
2020,United Arab Emirates,ARE,383,6551,6934
2020,Uganda,UGA,16,8,24
2020,Ukraine,UKR,491,171,662
2020,Uruguay,URY,63,6,69
2020,United States of America,USA,8616,2630,11246
2020,Venezuela (Bolivarian Republic of),VEN,32,0,32
2020,Yemen,YEM,3609,419,4028
2020,Zambia,ZMB,20,6,26
2021,Albania,ALB,15,6,21
2021,Algeria,DZA,6659,0,6659
2021,Angola,AGO,0,5,5
2021,Egypt,EGY,136727,0,136727
2021,Argentina,ARG,433,98,531
2021,Armenia,ARM,5335,8,5343
2021,Australia,AUS,640,53,693
2021,Austria,AUT,62408,10558,72966
2021,Azerbaijan,AZE,33,0,33
2021,Bahrain,BHR,5,36,41
2021,Belgium,BEL,19188,1980,21168
2021,Benin,BEN,32,12,44
2021,Burkina Faso,BFA,5,0,5
2021,Belarus,BLR,68,8,76
2021,Bolivia (Plurinational State of),BOL,22,0,22
2021,Brazil,BRA,3920,3969,7889
2021,Bosnia and Herzegovina,BIH,28,5,33
2021,Bulgaria,BGR,20067,2368,22435
2021,Canada,CAN,190,164,354
2021,Chad,TCD,48,19,67
2021,China,CHN,43,5,48
2021,Chile,CHL,113,32,145
2021,Cameroon,CMR,5,10,15
2021,Congo,COG,5,13,18
2021,Dem. Rep. of the Congo,COD,12,12,24
2021,Colombia,COL,11,7,18
2021,Costa Rica,CRI,5,25,30
2021,Cuba,CUB,36,9,45
2021,Cyprus,CYP,10735,5545,16280
2021,Czechia,CZE,358,0,358
2021,Denmark,DNK,19706,222,19928
2021,Djibouti,DJI,14,5,19
2021,Ecuador,ECU,157,0,157
2021,Estonia,EST,105,0,105
2021,Ethiopia,ETH,38,629,667
2021,Finland,FIN,2660,66,2726
2021,France,FRA,37375,1369,38744
2021,United Kingdom of Great Britain and Northern Ireland,GBR,11980,4795,16775
2021,Georgia,GEO,444,18,462
2021,Germany,DEU,621740,53750,675490
2021,Ghana,GHA,229,70,299
2021,Greece,GRC,39372,3933,43305
2021,Guinea,GIN,14,0,14
2021,Croatia,HRV,548,12,560
2021,Hungary,HUN,869,0,869
2021,Iceland,ISL,195,16,211
2021,Cote d'Ivoire,CIV,148,9,157
2021,India,IND,69,64,133
2021,Indonesia,IDN,20,24,44
2021,Ireland,IRL,2832,53,2885
2021,Iraq,IRQ,254561,0,254561
2021,Italy,ITA,3527,903,4430
2021,Jordan,JOR,672952,0,672952
2021,Japan,JPN,93,0,93
2021,Kazakhstan,KAZ,14,11,25
2021,Kenya,KEN,5,5,10
2021,Kyrgyzstan,KGZ,75,6,81
2021,Rep. of Korea,KOR,1250,28,1278
2021,Kuwait,KWT,150,104,254
2021,Liberia,LBR,27,18,45
2021,Libya,LBY,492,12632,13124
2021,Lebanon,LBN,840929,0,840929
2021,Liechtenstein,LIE,32,0,32
2021,Lithuania,LTU,463,5,468
2021,Luxembourg,LUX,2409,415,2824
2021,Latvia,LVA,312,5,317
2021,Madagascar,MDG,5,0,5
2021,Mauritania,MRT,368,141,509
2021,North Macedonia,MKD,17,0,17
2021,Monaco,MCO,5,0,5
2021,Rep. of Moldova,MDA,166,7,173
2021,Mexico,MEX,34,35,69
2021,Mali,MLI,24,433,457
2021,Malaysia,MYS,449,2858,3307
2021,Morocco,MAR,5082,0,5082
2021,Malta,MLT,1918,412,2330
2021,Netherlands,NLD,39388,6362,45750
2021,Niger,NER,5,0,5
2021,Nigeria,NGA,422,482,904
2021,Norway,NOR,15865,315,16180
2021,Nauru,NRU,0,5,5
2021,New Zealand,NZL,72,0,72
2021,Oman,OMN,8,27,35
2021,Pakistan,PAK,50,23,73
2021,Paraguay,PRY,84,17,101
2021,Peru,PER,47,11,58
2021,Philippines,PHL,130,44,174
2021,Poland,POL,254,62,316
2021,Portugal,PRT,861,0,861
2021,Qatar,QAT,30,109,139
2021,Romania,ROU,2258,179,2437
2021,South Africa,ZAF,38,20,58
2021,Russian Federation,RUS,297,62,359
2021,El Salvador,SLV,5,0,5
2021,Saudi Arabia,SAU,186,9884,10070
2021,Senegal,SEN,0,14,14
2021,Somalia,SOM,991,65,1056
2021,Spain,ESP,14987,1605,16592
2021,Serbia and Kosovo: S/RES/1244 (1999),SRB,45,9,54
2021,Sudan,SDN,93482,0,93482
2021,Slovakia,SVK,25,0,25
2021,Slovenia,SVN,326,13,339
2021,Sweden,SWE,115233,1510,116743
2021,Switzerland,CHE,20146,255,20401
2021,United Rep. of Tanzania,TZA,5,19,24
2021,Thailand,THA,215,5,220
2021,Togo,TGO,18,8,26
2021,Trinidad and Tobago,TTO,64,38,102
2021,Tunisia,TUN,2523,0,2523
2021,Turkey,TUR,3737369,0,3737369
2021,United Arab Emirates,ARE,439,6526,6965
2021,Uganda,UGA,18,8,26
2021,Ukraine,UKR,512,147,659
2021,Uruguay,URY,66,5,71
2021,United States of America,USA,8799,3500,12299
2021,Venezuela (Bolivarian Republic of),VEN,33,0,33
2021,Yemen,YEM,2513,420,2933
2021,Zambia,ZMB,36,5,41
2022,Albania,ALB,20,6,26
2022,Algeria,DZA,7345,0,7345
2022,Angola,AGO,0,5,5
2022,Egypt,EGY,143803,0,143803
2022,Argentina,ARG,440,100,540
2022,Armenia,ARM,4855,9,4864
2022,Australia,AUS,595,52,647
2022,Austria,AUT,67588,11589,79177
2022,Azerbaijan,AZE,34,0,34
2022,Bahrain,BHR,5,40,45
2022,Belgium,BEL,20086,1089,21175
2022,Benin,BEN,36,16,52
2022,Burkina Faso,BFA,5,5,10
2022,Belarus,BLR,59,12,71
2022,Bolivia (Plurinational State of),BOL,22,0,22
2022,Brazil,BRA,3971,3832,7803
2022,Bosnia and Herzegovina,BIH,25,5,30
2022,Bulgaria,BGR,22226,2451,24677
2022,Canada,CAN,411,246,657
2022,Chad,TCD,49,22,71
2022,China,CHN,39,6,45
2022,Chile,CHL,113,31,144
2022,Cameroon,CMR,5,10,15
2022,Congo,COG,5,12,17
2022,Dem. Rep. of the Congo,COD,12,14,26
2022,Colombia,COL,11,7,18
2022,Costa Rica,CRI,5,29,34
2022,Cuba,CUB,23,8,31
2022,Cyprus,CYP,10869,7229,18098
2022,Czechia,CZE,422,11,433
2022,Denmark,DNK,19424,203,19627
2022,Djibouti,DJI,15,5,20
2022,Dominican Rep.,DOM,5,0,5
2022,Ecuador,ECU,162,5,167
2022,Estonia,EST,94,0,94
2022,Ethiopia,ETH,55,613,668
2022,Finland,FIN,2610,100,2710
2022,France,FRA,39091,507,39598
2022,Gambia,GMB,5,0,5
2022,United Kingdom of Great Britain and Northern Ireland,GBR,12155,5898,18053
2022,Georgia,GEO,448,17,465
2022,Germany,DEU,664238,43628,707866
2022,Ghana,GHA,246,75,321
2022,Greece,GRC,41594,2188,43782
2022,Guinea,GIN,14,0,14
2022,Croatia,HRV,552,29,581
2022,Hungary,HUN,826,0,826
2022,Iceland,ISL,204,25,229
2022,Cote d'Ivoire,CIV,148,6,154
2022,India,IND,71,65,136
2022,Indonesia,IDN,19,25,44
2022,Ireland,IRL,2954,69,3023
2022,Iraq,IRQ,262756,0,262756
2022,Italy,ITA,3525,903,4428
2022,Jordan,JOR,675433,0,675433
2022,Japan,JPN,93,0,93
2022,Kazakhstan,KAZ,14,5,19
2022,Kenya,KEN,5,5,10
2022,Kyrgyzstan,KGZ,69,9,78
2022,Rep. of Korea,KOR,1250,28,1278
2022,Kuwait,KWT,147,107,254
2022,Liberia,LBR,28,33,61
2022,Libya,LBY,480,13682,14162
2022,Lebanon,LBN,831053,0,831053
2022,Liechtenstein,LIE,65,0,65
2022,Lithuania,LTU,479,35,514
2022,Luxembourg,LUX,2049,537,2586
2022,Latvia,LVA,317,0,317
2022,Madagascar,MDG,5,0,5
2022,Mauritania,MRT,381,183,564
2022,Monaco,MCO,5,0,5
2022,Rep. of Moldova,MDA,166,46,212
2022,Mexico,MEX,35,37,72
2022,Mali,MLI,24,433,457
2022,Malaysia,MYS,474,2868,3342
2022,Morocco,MAR,5250,0,5250
2022,Malta,MLT,1920,417,2337
2022,Netherlands,NLD,53496,7271,60767
2022,Niger,NER,5,11,16
2022,Nigeria,NGA,512,595,1107
2022,Norway,NOR,15901,414,16315
2022,Nauru,NRU,0,5,5
2022,New Zealand,NZL,66,0,66
2022,Oman,OMN,8,27,35
2022,Pakistan,PAK,50,23,73
2022,Paraguay,PRY,79,17,96
2022,Peru,PER,47,12,59
2022,Philippines,PHL,132,56,188
2022,Poland,POL,273,36,309
2022,Portugal,PRT,906,0,906
2022,Qatar,QAT,30,117,147
2022,Romania,ROU,2357,65,2422
2022,South Africa,ZAF,38,20,58
2022,Russian Federation,RUS,280,42,322
2022,Saudi Arabia,SAU,194,10625,10819
2022,Somalia,SOM,1018,98,1116
2022,Spain,ESP,14994,1080,16074
2022,Serbia and Kosovo: S/RES/1244 (1999),SRB,40,7,47
2022,Sudan,SDN,93480,0,93480
2022,Slovakia,SVK,26,0,26
2022,Slovenia,SVN,326,20,346
2022,Sweden,SWE,113213,1227,114440
2022,Switzerland,CHE,8039,272,8311
2022,United Rep. of Tanzania,TZA,9,20,29
2022,Thailand,THA,212,8,220
2022,Togo,TGO,19,9,28
2022,Trinidad and Tobago,TTO,53,35,88
2022,Tunisia,TUN,2669,0,2669
2022,Turkey,TUR,3648983,0,3648983
2022,United Arab Emirates,ARE,487,6486,6973
2022,Uganda,UGA,21,10,31
2022,Ukraine,UKR,513,28,541
2022,Uruguay,URY,66,5,71
2022,United States of America,USA,8843,3231,12074
2022,Venezuela (Bolivarian Republic of),VEN,33,0,33
2022,Yemen,YEM,2574,422,2996
2022,Zambia,ZMB,38,7,45
